chauffage : heating
chauffage central : central heating
combat : contest
combattre : fight, struggle
chauffer : warm (up), heat (up) 
comique : comic, comical, funny
chauffeur : driver
commande : order
commander : command
chaussette : sock 
commencer : begin
commencement : beginning
chaussure : shoe 
chaussure de ski : boot
commerçant : tradesman, shopkeeper
chef : chief, leader
commerce : commerce, trade, business
chemin : path, way
chemin de fer : railway
commercial : commercial 
cheminée : chimney
cheminée intérieure : fireplace
commode : convenient,handy, sultable
chemise : shirt
chemise de nuit: nightdress
commun : common; ordinary; public
chèque : check
carnet de chèque : check book
compagnie : company 
cher : dear; expensive ≠ cheap
chercher : look for, seek
aller chercher : meet, fetch
compétent : competent, efficient
chéri : darling
complet : complete; full, booked up
à cheval : on horseback
monter à cheval : ride a horse
composer : compose, arrange, make up
composition : composition
comprendre : understand, grasp; include
cheville : ankle
compte : account 
tenir compte de : take into account
chèvre : goat
je m'en rends compte :  I realize it
chien : dog
jeune chien : puppy
compter  :  count, reckon, 
compter sur : count/rely on
chiffre : figure
chiffre d’affaires : turnover
choć : shock, impact, crash
concerner : concern
chocolat : chocolate
choisir : choose, pick out, select
choix : choice, selection
chômage : unemployment 
être au chômage : be unemployed
chose : thing, matter
chrétien : Christian
chuchoter : whisper
ciel : sky
gratte-ciel : skyscraper
cigare : cigar
cigarette : cigarette
cinema : cinema, pictures, movies
circulation : traffic
circulation (sang) : circulation
cirer, cirage : polis
cirque : circus
ciseaux : scissors
citer : quote
citation : quotation
citron : lemon
clair : clear
classe : class
salle de classe : classroom
clé : key
client : customer, client
climat : climate
cloche : bell
clocher : bell-tower
clou : nail
clouer : nail/pin down
cochon : pig
cochon (viande) : pork
coeur : heart
mal au coeur : sea/air-sick
apprendre par coeur : learn by heart
avoir bon coeur : be good/kind hearted
coffre : chest/boot/trunk
coiffeur : hairdresser
coiffure : hair-style
coin : corner
coin (lieu) : area, spot
col : colar
col (géo) : pass
colère : anger
être en colère : be angry
colis : parcel, package 
colle, coller : glue, paste, stick
collection : collection
collectionner : collect, gather
colline : hill
condition : condition, terms
conduire : lead, drive
conducteur : driver
se conduire : behave
confiance : confidence, trust
faire confiance à : have confidence in, trust somebody
confiture : jam
confiture d’agrumes : marmelade
confondre : mix up, confuse, be mistaken
confort : comfort
confortable : comfortable
congé : holiday, day off, leave
connaissance : knowledge
faire connaissance : get to know, make somebody’s acquaintance 
connaître : know, be acquainted with
conscient : conscious
conscience : conscience
conseil(s) : advice
conseiller (verbe) : advise
conséquence : consequence, result
considérer : consider
considérer comme : regard as
consister en, à : consist of sth, in doing sth
consommer : consume
consommation : consumption
construire : build
construction : building
contact : contact
prendre contact : get in touch
contenir : contain, hold
content : glad, satisfied, pleased, happy
contenu : content
contenu (récipient) : contents
continuer : go/carry on, continue
contraire : contrary
au contraire : on the contrary
contrôle : control
contrôler : check
convaincre : convince, persuade
convenir : suit
convenable : suitable, decent
conversation : conversation, talk
copie : copy
copie (école) : paper script
copier : copy, imitate, crib from somebody
coq : cock
coquille : shell
coquillage : sea-shell
corde : rope
cordelette : string (musique), cord
corps : body
correct : correct, right, accurate
corriger : correct, put right, marks (devoirs)
contenir un danger : to contain an outbreak
gagne-pain : livelihood
extrêmement choquant : staggering
réfuter : tu rebut/to debunk (a myth)
il est essentiel de : it is critical that
essentiel / critique : critical
ancien élève : alumni
répéter (un discours) : to rehearse
parler d'un sujet : to discuss a topic / to talk about a topic
camarade/confrère : peer (also for a member of the House of Lords)
sondage : poll
atteindre : reach/hit/achieve
rebond/reprise : rebound
contraignant/restrictif : constraining
respectueux de / conforme à : compliant with
hausse soudaine : surge
licencier / virer : dismiss / fire
piquer/planter : jab (past jabbed)
abandonner/laisser tomber : scrap/ditch
peu enthousiaste : uneager
congé (travail) : furlough
cette école compte 5000 étudiants : it has 5000 students (not counts)
magnat : tycoon
canaliser : funnel
entonnoir : funnel
persistant/obstiné : dogged
être vendu : to be sold off
défendre/soutenir : uphold
paradis fiscal : tax haven
intérêt direct : vested interest
to bring someone somewhere to do a particular job : to draft somebody in
promouvoir / vanter : to tout
minimiser (un danger) : downplay
aggraver / accentuer : exacerbate
éviter : avert
journal (quotidien) : newspaper
revue / bulletin : journal
loisir : leisure
puce électronique : microchip
restriction : restriction
aperçu / instantané : snapshot
croissance : growth
augmenter/croître (pour une économie) : expand/grow
ralentissement économique : economic slump
augmenter/élever (causé par un agent tiers) : raise
augmenter (mouvement endogène) : rise
acceptable/ appétissant : palatable
retraite : retirement
retirer : withdraw
en attendant : pending
présider / diriger : chair
prévenir : warn
marchand / commerçant : merchant
présenter qqch à qqn : present smtg to someone
attirer / appâter : entice
être ébranlé par : to be reeling from
être intimidé/effrayé : to be cowed
affluer (personnes) : flock
attiser : stoke
compter/estimer : reckoning
répercussions/retombées : fallout
racheter/acheter en grande quantité : buy up
lanceur d'alerte : whistleblower
obligatoire (cours) : mandatory
en option (cours) : elective
atténuer : abate
emmêler : snarl (up) 
chaos/pagaille : havoc
paralyser (immatériel) : hamstring
modéré/contenu : subdued
maîtriser/soumettre : subdue smtg/sb
morose/lent/mou : sluggish
faire trembler qqch : rattle smtg
coupé/muet/discret : muted
flambée (prix) : a spike
annoncé/sorti/publié : distributed
pour l'instant : as for now
titulaire : incumbent
intendance : stewardship
faire face à un problème/obstacle : hit a snag
discuter / quereller : wrangle with
souffre-douleur : punching bag